#S########
#   ######
## #######
#  ##   ##
##    ####
#### #####
####     E
##########