#S########
#** ######
##*#######
# *##   ##
##*** ####
####*#####
####*****E
##########
